1 96 83 56 89 79 73 34 70 57 15
2 7 32 98 5 39 66 88 53 29 60
3 75 30 59 52 93 4 44 92 24 62
4 44 92 24 62 41 17 94 99 76 74
5 39 66 88 53 29 60 50 31 37 81
6 80 84 2 7 32 98 5 39 66 88
7 32 98 5 39 66 88 53 29 60 50
8 19 58 67 80 84 2 7 32 98 5
9 25 16 27 63 8 19 58 6 80 84
10 78 77 87 72 71 65 20 64 12 1
11 86 40 90 18 45 3 75 30 59 52
12 1 96 83 56 89 79 73 34 70 57
13 91 13 91 13 91 13 91 13 91 13
14 21 36 28 69 14 21 36 28 69 14
15 43 95 68 23 46 51 11 86 40 90
16 27 63 8 19 58 6 80 84 2 7
17 94 99 76 74 48 49 9 25 16 27
18 45 3 75 30 59 52 93 4 44 92
19 58 6 80 84 2 7 32 98 5 39
20 64 12 1 96 83 56 89 79 73 34
21 36 28 69 14 21 36 28 69 14 21
22 33 85 26 10 78 77 87 72 71 65
23 46 51 11 86 40 90 18 45 3 75
24 62 41 17 94 99 76 74 48 49 9
25 16 27 63 8 19 58 6 80 84 2
26 10 78 77 87 72 71 65 20 64 12
27 63 8 19 58 6 80 84 2 7 32
28 69 14 21 36 28 69 14 21 36 28
29 60 50 31 37 81 54 38 97 61 42
30 59 52 93 4 44 92 24 62 41 17
31 37 81 54 38 97 61 42 47 35 67
32 98 5 39 66 88 53 29 60 50 31
33 85 26 10 78 77 87 72 71 65 20
34 70 57 15 43 95 68 23 46 51 11
35 67 82 55 22 33 85 26 10 78 77
36 28 69 14 21 36 28 69 14 21 36
37 81 54 38 97 61 42 47 35 67 82
38 97 61 42 47 35 67 82 55 22 33
39 66 88 53 29 60 50 31 37 81 54
40 90 18 45 3 75 30 59 52 93 4
41 17 94 99 76 74 48 49 9 25 16
42 47 35 6 82 55 22 33 85 26 10
43 95 68 23 46 51 11 86 40 90 18
44 92 24 62 41 17 94 99 76 74 48
45 3 75 30 59 52 93 4 44 92 24
46 51 11 86 40 90 18 45 3 75 30
47 35 67 82 55 22 33 85 26 10 78
48 49 9 25 16 27 63 8 19 58 6
49 9 25 16 27 63 8 19 58 6 80
50 31 37 81 54 38 97 61 42 47 35
51 11 86 40 90 18 45 3 75 30 59
52 93 4 44 92 24 62 41 17 94 99
53 29 60 50 31 37 81 54 38 97 61
54 38 97 61 42 47 35 67 82 55 22
55 22 33 85 26 10 78 77 87 72 71
56 89 79 73 34 70 57 15 43 95 68
57 15 43 95 68 23 46 51 11 86 40
58 6 80 84 2 7 32 98 5 39 66
59 52 93 4 44 92 24 62 41 17 94
60 50 31 37 81 54 38 97 61 42 47
61 42 47 35 9 82 55 22 33 85 26
62 41 17 94 99 76 74 48 49 9 25
63 8 19 58 6 80 84 2 7 32 98
64 12 1 96 83 56 89 79 73 34 70
65 20 64 12 1 96 83 56 89 79 73
66 88 53 29 60 50 31 37 81 54 38
67 82 55 22 33 85 26 10 78 77 87
68 23 46 51 11 86 40 90 18 45 3
69 14 21 36 28 69 14 21 36 28 69
70 57 15 43 95 68 23 46 51 11 86
71 65 20 64 12 1 96 83 56 89 79
72 71 65 20 64 12 1 96 83 56 89
73 34 70 57 15 43 95 68 23 46 51
74 48 49 9 25 16 27 63 8 19 58
75 30 59 52 93 4 44 92 24 62 41
76 74 48 49 67 25 16 27 63 8 19
77 87 72 71 65 20 64 12 1 96 83
78 77 87 72 71 65 20 64 12 1 96
79 73 34 70 57 15 43 95 68 23 46
80 84 2 7 32 98 5 39 66 88 53
81 54 38 97 61 42 47 35 67 82 55
82 55 22 33 85 26 10 78 77 87 72
83 56 89 79 73 34 70 57 15 43 95
84 2 7 32 98 5 39 66 88 53 29
85 26 10 78 77 87 72 71 65 20 64
86 40 90 18 45 3 75 30 59 52 93
87 72 71 65 20 64 12 1 96 83 56
88 53 29 60 50 31 37 81 54 38 97
89 79 73 34 70 57 15 43 95 68 23
90 18 45 3 75 30 59 52 93 4 44
91 13 91 13 91 13 91 13 91 13 91
92 24 62 41 17 94 99 76 74 48 49
93 4 44 92 24 62 41 17 94 99 76
94 99 76 74 48 49 9 25 16 27 63
95 68 23 46 51 11 86 40 90 18 45
96 83 56 89 79 73 34 70 57 15 43
97 61 42 47 35 67 82 55 22 33 85
98 5 39 66 88 53 29 60 50 31 37
99 76 74 48 49 9 25 16 27 63 8
